#############################################################################################################################
#                                             O                                                                             #
#      ########                          ######################## ############### ####################################      #
#      #      #                          #                   X                                                       #      #
#      #  L   #                          #                                                                           #      #
#      #      #             X                   ############## #############      ############# ###############      #      #
#             #                          #      #                          #      #                           #      #      #
#      #                                 #      #           O              #      #      X        O           #      #      #
#      #      #          O               #      #                          #      #                           #      #      #
#      #      #                          #      ############################      #             X             #      #      #
#      #      #                          #                               X        #                           #      #      #
#      #   X  #                          #                                                           O               #      #
#      #      #                          #                 X                      #                           #      #      #
#      #      #                 O        #      ############ ###############      #                           #      #      #
#      #      #           X              #      #                          #      #     O                     #      #      #
#      #      #                          #      #                          #      #                           #      #      #
#      #  X   #                          #      #               X          #      #                           #      #      #
#      #      ### ## ## ## ## ## ## ## ###      ############################      ############### #############      #      #
#      #                                                                        O                                           #
#      #                                                                                                             #      #
#      # # # ####################### # # ##################### ########################### ###########################      #
#      #                                 #                                 #                                        O#      #
#      #   P                     X       #                  O              #                                         #      #
#      #      #####################      #      ######### ###########             ############# ######################      #
#             #                   #      #      #                   #      #      #                                         #
#      #                O                #                O                #      #                                         #
#      #      #                   #      #      #                   #      #      #            O                 O          #
#      #      #####################      #      ########## ##########      #                                                #
#      #  X                              #                                 #      #                                         #
#      #                                 #                                 #      #      X        ####################      #
#      #      ############# ##############      ############# #######      #      #               #                  #      #
#      #      #                          #      #                   #      #      #               # O                #      #
#      #      #                O         #      #                   #      #      #               #############      #      #
#      #      #       X                  #      #                   #      #      #                           #      #      #
#      #      #                          #      #                   #      #      #                           #      #      #
#      #      #                          #      #                   #      #      #            O              #             #
#      #      #             X            #      #                   #      #      #                           #      #      #
#      #      #                          #      #                   #             ######### ###################      #      #
#      #  O   #                          #      #                   #      #                                  X      #      #
#      #      #                          #      #                   #      #                                         #      #
#      ########                          ### ####       X           ### ########### ##################################    X #
#                                                                                                                           #
############################################################################################################################# 