####################
#     O X       L ##
#######   ##########
#                 ##
#  X        O  P  ##
#     X     O     ##
####################
